*****************
*A *   B        *
*  ***********  *
*       *       *
******  ******  *
*               *
******  *********
*               *
*****************
